11111111111111111111111111111111111111111111111111
1MMCCMMMMMPCMCMEC0CMMMMMCMC000000CCMCCCMCCC0000MM1
10C00MC0C0C0C0MMMMM0MC0C00M00CC0CMM0MMCMC000C00CC1
1CC00C00CM0CM0CM0MCC00CCC0CC0C0M0C00CCM0000MMMM001
10M0CC000CMCM0MCCC0M0MMC00MMMCMCCCM0C0M0M0C0CCC001
10CCMCMC0CM0CM0CMC0CCM0000CC0MMCM000C0MM000M0MCMC1
1MMC0CMMCCM0CC0MM00MMCC0MMCC00M00CC0CCMC0000MMCM01
10C0CCMCCCC0MMMC00MMCM0CCC0MM0MMMMCMCCMM0CM0C0C001
1000MC0C0CC0MM0CMCMCCC0MMCMMCC00CCCMMMM00MCM0C0C01
11111111111111111111111111111111111111111111111111
