1111111111111111111111111
1000000000000000000000001
100000000M00000000C000001
1000000000000000000000001
100000C000000000000000001
100P000000C00000000000001
100000000000000000C0000E1
1000000000000000000000001
100000C000000000000000001
1000000000000000000000001
100000000000000C0M0000001
1000000000000000000000001
100C000000000000000000001
1000000000000000000000001
1111111111111111111111111