1111111
100C001
00P00M0
100E001
1111111