11111111111111111111111
1000000000000100E000001
10C000000C000000000C001
1101110000111100C000001
10000000001111000000001
1111111100011100P000001
10000000000001000000001
10000000000010000000001
11011100001111000000001
10000000000000000000001
11111111111111111111111