1111111111111111111111111111111111111111
1P000C0000000000000000000000000000C000E1
1000111111001111111000111111001111111101
10C0010000100001000010000100001000010001
1000010111101111011110111101111011110111
1000010000100001000000000100000000010001
1111111111101111111111111011111111110111
1000000000000000000000000000000000000001
1011111111111111111111111111111111111101
100000C0000000000C0000000000C00000000001
1110111111111110111111111110111111111111
1000000000000000000000000000000000000001
1011101111111111111111111111111111111101
1000100000000000000000000000000000000001
1011101110111011101110111011101110111011
1000100010001000100010001000100010001001
1011101110111011101110111011101110111011
1000100010001000100010001000100010001001
1011111111111111111111111111111111111101
1000000000000000000000000000000000000C01
1011111111111111111111111111111111111111
1000000000000000000000000000000000000001
1011111111111111111111111111111111111101
10C0000000000000000000000000000000000001
1111111111111111111111111111111111111111