11111111111111111111111
1C000000000000100000001
100000000M000000000C001
1111110000111100C000001
1E0000000011110000M0001
11111111000111000000001
10000000000001000000001
10C00M000000010000M0001
1101110000111100000C001
10000000001C0000P000001
11111111111111111111111