11111111
1P010E01
1001C101
11000001
1110C0M1
1C0C0001
10011C01
11111111