11111111
1E000001
1111P111
11000001
1110C0M1
1C0C0001
10011C01
11111111z